"filename", "language", "Python", "Markdown", "comment", "blank", "total"
"/home/wencanwu/Code/Post-processing/BLprofile.py", "Python", 310, 0, 50, 4, 364
"/home/wencanwu/Code/Post-processing/IB_force.py", "Python", 73, 0, 28, 8, 109
"/home/wencanwu/Code/Post-processing/Note.py", "Python", 20, 0, 6, 0, 26
"/home/wencanwu/Code/Post-processing/README.md", "Markdown", 0, 3, 0, 2, 5
"/home/wencanwu/Code/Post-processing/ReadIn.py", "Python", 382, 0, 72, 7, 461
"/home/wencanwu/Code/Post-processing/ReadInBinary.py", "Python", 81, 0, 32, 31, 144
"/home/wencanwu/Code/Post-processing/block.py", "Python", 31, 0, 6, 6, 43
"/home/wencanwu/Code/Post-processing/get_BLprofile.py", "Python", 23, 0, 35, 14, 72
"/home/wencanwu/Code/Post-processing/get_Cf.py", "Python", 53, 0, 5, 12, 70
"/home/wencanwu/Code/Post-processing/get_IB.py", "Python", 18, 0, 4, 9, 31
"/home/wencanwu/Code/Post-processing/line_field.py", "Python", 136, 0, 14, 35, 185
"/home/wencanwu/Code/Post-processing/plotlines/plt_Cf.py", "Python", 85, 0, 2, 15, 102
"/home/wencanwu/Code/Post-processing/plotlines/plt_RSprofile.py", "Python", 64, 0, 7, 8, 79
"/home/wencanwu/Code/Post-processing/plotlines/plt_Tprofile.py", "Python", 80, 0, 10, 7, 97
"/home/wencanwu/Code/Post-processing/plotlines/plt_u.py", "Python", 216, 0, 20, 18, 254
"/home/wencanwu/Code/Post-processing/plotlines/plt_uprofile.py", "Python", 68, 0, 6, 9, 83
"/home/wencanwu/Code/Post-processing/plt2pandas.py", "Python", 606, 0, 158, 57, 821
"/home/wencanwu/Code/Post-processing/run.py", "Python", 23, 0, 15, 12, 50
"/home/wencanwu/Code/Post-processing/timer.py", "Python", 10, 0, 11, 9, 30
"Total", "-", 2279, 3, 481, 263, 3026